30
15
##############################
#---------P#---------#########
#----#######-O-#------########
#--------------#--------######
#--#---#---##########---######
#--#-G-#-G-###---##--G-#######
#--#-------###---###------####
D@---T########-G-------------D
#--#-------###---###------####
#--#-G-#-G-###---##--G-#######
#--#---#---##########---######
#--------------#--------######
#----#######-O-#------########
#---------P#---------#########
##############################

